21 21 3
#####################
#R..................#
#######....##########
#..........#........#
#....M...C.#........#
#..........####..M..#
#......M......#.....#
#...................#
#########........####
#...........C.......#
#...................#
#....M......#########
#...........#.......#
#.....C.#####...M...#
#...................#
#...M..........######
#.........M.........#
#######........C....#
#.............#.....#
#.............#.....#
#####################